{
	"tileset" : "damier.png",
	"size" : [3, 4],
    "map" : [
        [10, 11, 10, 11, 10, 11, 10, 11],
        [11, 10, 11, 10, 11, 10, 11, 10],
        [10, 11, 10, 11, 10, 11, 10, 11],
        [11, 10, 11, 10, 11, 10, 11, 10],
        [10, 11, 10, 11, 10, 11, 10, 11],
        [11, 10, 11, 10, 11, 10, 11, 10],
        [10, 11, 10, 11, 10, 11, 10, 11],
        [11, 10, 11, 10, 11, 10, 11, 10]
    ]
}