{
	"tileset" : "damier.png",
	"size" : [2, 1],
    "map" : [
        [1, 2, 1, 2, 1, 2, 1, 2],
        [2, 1, 2, 1, 2, 1, 2, 1],
        [1, 2, 1, 2, 1, 2, 1, 2],
        [2, 1, 2, 1, 2, 1, 2, 1],
        [1, 2, 1, 2, 1, 2, 1, 2],
        [2, 1, 2, 1, 2, 1, 2, 1],
        [1, 2, 1, 2, 1, 2, 1, 2],
        [2, 1, 2, 1, 2, 1, 2, 1]
    ]
}