{    
    "tileset" : "tile_wood.png",
    "size" : [7, 3],
    "map" : [
        [3, 4, 4, 4, 4, 4, 4, 4, 4, 5],
        [10, 2, 16, 2, 16, 2, 16, 2, 16, 12],
        [10, 16, 2, 16, 2, 16, 2, 16, 2, 12],
        [10, 2, 16, 2, 16, 2, 16, 2, 16, 12],
        [10, 16, 2, 16, 2, 16, 2, 16, 2, 12],
        [10, 2, 16, 2, 16, 2, 16, 2, 16, 12],
        [10, 16, 2, 16, 2, 16, 2, 16, 2, 12],
        [10, 2, 16, 2, 16, 2, 16, 2, 16, 12],
        [10, 16, 2, 16, 2, 16, 2, 16, 2, 12],
        [17, 18, 18, 18, 18, 18, 18, 18, 18, 19]
    ]
}