{    
    "tileset" : "tile_wood.png",
    "size" : [3, 4],
    "map" : [
        [1, 2, 2, 2, 2, 2, 2, 2, 2, 3],
        [4, 10, 11, 10, 11, 10, 11, 10, 11, 6],
        [4, 11, 10, 11, 10, 11, 10, 11, 10, 6],
        [4, 10, 11, 10, 11, 10, 11, 10, 11, 6],
        [4, 11, 10, 11, 10, 11, 10, 11, 10, 6],
        [4, 10, 11, 10, 11, 10, 11, 10, 11, 6],
        [4, 11, 10, 11, 10, 11, 10, 11, 10, 6],
        [4, 10, 11, 10, 11, 10, 11, 10, 11, 6],
        [4, 11, 10, 11, 10, 11, 10, 11, 10, 6],
        [7, 8, 8, 8, 8, 8, 8, 8, 8, 9]
    ]
}